***************************
***************************
***************************
******************      ***
********                ***
******** *********      ***
*****      *******  *******
*****      *******  *******
*****      *******  *******
*****      ******     *****
*****      ******     *****
*****      ******     *****
*****      ******** *******
******************* *******
******************* *******
******************* *******
**      *********** *******
**      ***   ***** *******
**            ***** *******
**      ***   **       ****
***********   **       ****
***********            ****
***********   **       ****
************ **** *********
************ **** *********
************ **** *********
**       **   **   ********
**            **   ********
**       **   **   ********
***********   **   ********
***********   *************
***************************
***************************
***************************
