*******************************************
*******************************************
*********************************   *******
***********                             ***
***   ***    ***             ****   *** ***
***          ***       ****   **** ***   **
***   ***    *************    **** ***   **
***   ***** **************    **** ***   **
*********** ************** ******   **   **
*********** ************** ******   **   **
*********** ****    *****     ***   *** ***
*********** ****              ***   *** ***
**********   ***    *****     ***   *** ***
**   *****   **** ********* *****   **   **
**           **** ********* ****** ***   **
**   *****   **** ********* ****** ***   **
**   ****** ****   ******** ****** **** ***
*********** ****   ****      ****   *** ***
*********** ****   ****      ****   *** ***
*********** ****   ****      ****   *** ***
**    ***    ***   ****      ****   **   **
**           ***   *************** ***   **
**    ***    ********************* ***   **
*********** ********************** **** ***
*********** ********************** **** ***
***    **** ****       ***     *** **** ***
***    **** ****       ***     **   *** ***
***    ***   ***               **   *** ***
***    ***   ***       ***     **   **   **
***    ***   *************     **   **   **
***    ***   *************          **   **
***          *************     **   **   **
***    ***   ********************   *******
***    ***   ********************   *******
*******************************************
*******************************************
